%%%%%%%%%%%%%%%%%%%%%%%%%%%%%%%%%%%%%%%%%%%
%P   .....    ....       ...        ..... %
%   ......   ......     .....      ...... %
%  ... ...  ...  ...   ... ...    ... ... %
% ...  ...  ...  ...  ...   ...  ...  ... %
% ........   ......   ... G ...  ........ %
% ........  ...  ...  ...   ...  ........ %
%      ...  ...  ...   ... ...        ... %
%      ...   ......     .....         ... %
%      ...    ....       ...     o    ... %
%%%%%%%%%%%%%%%%%%%%%%%%%%%%%%%%%%%%%%%%%%%